X # # # # # X
X # .   T # #
X # T $ $ T #
X # # T     #
X X # # T   #
X X X # # . #
X X X X # # #
