X X X X X X X X # # # # #
X # # # # # # # # T T T #
X # .       .     @ # . #
X # T   # # # T         #
X # #   $   T # T T T T #
X X #   $     T # # # # #
X X # T $ #   T # X X X X
X X # #   #   T # X X X X
X X X # T T T # # X X X X
X X X # # # # # X X X X X
