X X X X X X X X X # # # # # # # # # # # # # # # # # # # X
X X X X X X X X # T T T T T # T T T T T T T T # T     . #
X X X X X X X X # T @     T # T     $         # T     T #
# # # # # # # # # #   # # T # T # # # # #     # #     # #
# T T T T T T T T     T # T # T # T T T # T           T #
# # # # # # # # #   $ T # T # T #   $ T # # # # # #   T #
X X X X X X X X #     T # T T T #     T # T T         T #
X X X X X X X X #   # # # # # # #   # # # # #   # # # # #
X X X X X X X X # T     $       .           .   T T T T #
X X X X X X X X # # # # # # # # # # # # # # # # # # # # X
