X X X X # # # # # # X X X X
X # # # T T T T T T # # # X
X # T   $   $           T #
X # T .       @         . #
X # # # # # # # # # # # # X
