0 0
#####  ###
# #  ###.#
# # .    #
#   ###  #
# $      #
#        #
#@ ### ###
##  $  #  
 ##   # # 
  ####### 
